$ help
Use the following shell commands:
cd	change directory [dir_name]
cat	print file [file_name]
deleteme	delete all of your data associated with foobar
edit	open file in editor [file_name]
feedback	provide feedback on foobar
less	print a file a page at a time [file_name]
ls	list directory contents [dir_name]
request	request new challenge (of type 'tag') [tag]
status	print progress
submit	submit final solution file for assessment [file_name]
tags	print tag list
verify	runs tests on solution file [file_name]



$ tags
Requesting tags...
algo           	algorithms
data_struct    	data structures
low_level      	low-level representation (binary representations, endianness)
math           	math
crypto         	security and cryptography
